{
	"name" : "Level 1",
	"map_size" : {
		"x" : 13,
		"y" : 10
	},
	"map" : [
			[0, 0, 0, 0, 0, 0, 0, 0, 0, 0, 0, 0, 0],
			[0, 0, 0, 0, 0, 0, 0, 0, 0, 0, 0, 0, 0],
			[0, 0, 0, 0, 0, 0, 0, 0, 0, 0, 0, 0, 0],
			[0, 0, 0, 0, 0, 0, 2, 2, 2, 2, 2, 2, 2],
			[0, 0, 0, 0, 0, 0, 2, 1, 1, 1, 0, 0, 2],
			[1, 1, 1, 1, 1, 0, 2, 1, 1, 1, 2, 0, 2],
			[1, 1, 1, 1, 1, 0, 2, 1, 1, 1, 2, 0, 2],
			[1, 1, 1, 1, 1, 0, 2, 2, 2, 2, 2, 0, 2],
			[1, 1, 1, 1, 1, 0, 0, 0, 0, 0, 0, 0, 0],
			[1, 1, 1, 1, 1, 0, 0, 0, 0, 0, 0, 0, 0]
			],
	"spawn" : {
		"x" : 2,
		"y" : 7
	},
	"exit" : {
		"x" : 8,
		"y" : 5
	},
	"cuts_allowed" : 2,
	"current_level" : 4,
	"next_level" : 5
}
