{
	"name" : "Level 1",
	"map_size" : {
		"x" : 11,
		"y" : 10
	},
	"map" : [
			[1, 0, 1, 0, 0, 0, 0, 0, 0, 0, 0],
			[1, 0, 1, 0, 0, 0, 2, 2, 2, 2, 2],
			[1, 0, 1, 0, 0, 0, 2, 1, 1, 1, 2],
			[1, 0, 1, 0, 0, 0, 2, 1, 1, 1, 2],
			[0, 0, 0, 0, 0, 0, 2, 1, 1, 1, 2],
			[2, 2, 2, 2, 2, 0, 2, 2, 2, 2, 2],
			[2, 1, 1, 1, 2, 0, 0, 0, 0, 0, 0],
			[2, 1, 1, 1, 2, 0, 0, 0, 0, 0, 0],
			[2, 1, 1, 1, 2, 0, 0, 0, 0, 0, 0],
			[2, 2, 2, 2, 2, 0, 0, 0, 0, 0, 0]
			],
	"spawn" : {
		"x" : 1,
		"y" : 6
	},
	"exit" : {
		"x" : 8,
		"y" : 2
	},
	"number_of_orbs" : 0,
	"orb_positions" : [
		{ "x" : 0, "y" : 0 }
	],
	"cuts_allowed" : 1,
	"current_level" : 3,
	"next_level" : 4
}
