{
	"name" : "Level 8",
	"map_size" : {
		"x" : 16,
		"y" : 10
	},
	"map" : [
			[0, 0, 0, 0, 0, 0, 0, 0, 0, 0, 0, 0, 0, 0, 0, 0],
			[0, 0, 0, 0, 0, 0, 0, 0, 0, 0, 0, 0, 1, 1, 1, 1],
			[0, 0, 0, 4, 4, 4, 4, 4, 4, 4, 0, 0, 1, 1, 1, 1],
			[4, 4, 4, 4, 3, 4, 0, 0, 0, 4, 0, 0, 1, 1, 1, 1],
			[4, 3, 4, 4, 0, 4, 0, 4, 0, 4, 0, 0, 1, 1, 1, 1],
			[4, 0, 4, 0, 0, 4, 0, 4, 3, 4, 0, 0, 0, 0, 0, 0],
			[4, 0, 4, 0, 4, 4, 0, 4, 4, 4, 0, 0, 0, 0, 0, 0],
			[3, 3, 3, 3, 3, 3, 3, 3, 3, 3, 3, 3, 3, 0, 0, 0],
			[3, 3, 3, 3, 3, 3, 3, 3, 3, 3, 3, 3, 3, 0, 0, 0],
			[3, 3, 3, 3, 3, 3, 3, 3, 3, 3, 3, 3, 3, 0, 0, 0],
			],
	"spawn" : {
		"x" : 1,
		"y" : 8
	},
	"exit" : {
		"x" : 10,
		"y" : 8
	},
	"number_of_orbs" : 3,
	"orb_positions" : [
		{ "x" : 1, "y" : 4 },
		{ "x" : 4, "y" : 3 },
		{ "x" : 8, "y" : 5 }
	],
	"cuts_allowed" : 6,
	"current_level" : 9,
	"next_level" : 9
}
