{
	"name" : "Level 8",
	"map_size" : {
		"x" : 13,
		"y" : 10
	},
	"map" : [
			[0, 0, 0, 0, 0, 0, 0, 0, 0, 0, 0, 0, 0],
			[0, 2, 2, 2, 0, 2, 2, 2, 0, 2, 2, 2, 0],
			[0, 2, 1, 2, 0, 2, 1, 2, 0, 2, 1, 2, 0],
			[0, 2, 2, 2, 0, 2, 2, 2, 0, 2, 2, 2, 0],
			[0, 0, 0, 0, 0, 0, 0, 0, 0, 0, 0, 0, 0],
			[0, 0, 0, 0, 0, 0, 0, 0, 0, 0, 0, 0, 0],
			[0, 0, 0, 0, 0, 0, 0, 0, 0, 0, 0, 0, 0],
			[1, 1, 1, 1, 1, 1, 1, 1, 1, 3, 3, 3, 1],
			[1, 1, 1, 1, 1, 1, 1, 1, 1, 3, 3, 3, 1],
			[1, 1, 1, 1, 1, 1, 1, 1, 1, 3, 3, 3, 1],
			],
	"spawn" : {
		"x" : 1,
		"y" : 8
	},
	"exit" : {
		"x" : 10,
		"y" : 8
	},
	"number_of_orbs" : 3,
	"orb_positions" : [
		{ "x" : 2, "y" : 2 },
		{ "x" : 6, "y" : 2 },
		{ "x" : 10, "y" : 2 }
	],
	"cuts_allowed" : 1,
	"current_level" : 8,
	"next_level" : 9
}
