{
	"name" : "Level 1",
	"map_size" : {
		"x" : 13,
		"y" : 10
	},
	"map" : [
			[0, 0, 0, 0, 0, 0, 0, 0, 0, 0, 0, 0, 0],
			[0, 0, 0, 0, 0, 0, 0, 0, 0, 0, 0, 0, 0],
			[0, 0, 0, 0, 0, 0, 0, 0, 0, 0, 0, 0, 0],
			[0, 0, 0, 0, 0, 0, 4, 4, 4, 4, 4, 4, 4],
			[0, 0, 0, 0, 0, 0, 4, 3, 3, 3, 0, 0, 4],
			[1, 1, 1, 1, 1, 0, 4, 3, 3, 3, 4, 0, 4],
			[1, 1, 1, 1, 1, 0, 4, 3, 3, 3, 4, 0, 4],
			[1, 1, 1, 1, 1, 0, 4, 4, 4, 4, 4, 0, 4],
			[1, 1, 1, 1, 1, 0, 0, 0, 0, 0, 0, 0, 0],
			[1, 1, 1, 1, 1, 0, 0, 0, 0, 0, 0, 0, 0]
			],
	"spawn" : {
		"x" : 2,
		"y" : 7
	},
	"exit" : {
		"x" : 8,
		"y" : 5
	},
	"number_of_orbs" : 0,
	"orb_positions" : [
		{ "x" : 0, "y" : 0 }
	],
	"cuts_allowed" : 2,
	"current_level" : 6,
	"next_level" : 7
}
