{
	"name" : "Level 7",
	"map_size" : {
		"x" : 13,
		"y" : 9
	},
	"map" : [
			[0, 0, 0, 0, 0, 0, 0, 0, 0, 0, 0, 0, 0],
			[0, 0, 0, 0, 0, 2, 2, 2, 0, 0, 0, 0, 0],
			[0, 0, 0, 0, 0, 2, 1, 2, 0, 0, 0, 0, 0],
			[0, 0, 0, 0, 0, 2, 2, 2, 0, 0, 0, 0, 0],
			[1, 1, 1, 1, 1, 1, 1, 1, 1, 1, 1, 1, 1],
			[1, 1, 1, 1, 1, 1, 1, 1, 1, 3, 3, 3, 1],
			[1, 1, 1, 1, 1, 1, 1, 1, 1, 3, 3, 3, 1],
			[1, 1, 1, 1, 1, 1, 1, 1, 1, 3, 3, 3, 1],
			[1, 1, 1, 1, 1, 1, 1, 1, 1, 1, 1, 1, 1]
			],
	"spawn" : {
		"x" : 2,
		"y" : 7
	},
	"exit" : {
		"x" : 10,
		"y" : 6
	},
	"number_of_orbs" : 1,
	"orb_positions" : [
		{ "x" : 6, "y" : 2 }
	],
	"cuts_allowed" : 1,
	"current_level" : 7,
	"next_level" : 8
}
