{
	"name" : "Level 1",
	"map_size" : {
		"x" : 9,
		"y" : 10
	},
	"map" : [
			[0, 0, 0, 0, 0, 0, 0, 0, 0],
			[0, 0, 0, 0, 2, 2, 2, 2, 2],
			[0, 0, 0, 0, 2, 1, 1, 1, 2],
			[0, 0, 0, 0, 2, 1, 1, 1, 2],
			[0, 0, 0, 0, 2, 1, 1, 1, 2],
			[2, 2, 2, 2, 2, 2, 2, 2, 2],
			[2, 1, 1, 1, 2, 1, 1, 1, 2],
			[2, 1, 1, 1, 2, 1, 1, 1, 2],
			[2, 1, 1, 1, 2, 1, 1, 1, 2],
			[2, 2, 2, 2, 2, 2, 2, 2, 2]
			],
	"spawn" : {
		"x" : 1,
		"y" : 6
	},
	"exit" : {
		"x" : 6,
		"y" : 2
	},
	"cuts_allowed" : 2,
	"current_level" : 2,
	"next_level" : 3
}
